{
  "<pad>": 0,
  "<eos>": 1,
  "\n": 2,
  " ": 3,
  "!": 4,
  "\"": 5,
  "$": 6,
  "%": 7,
  "&": 8,
  "'": 9,
  ",": 10,
  "-": 11,
  ".": 12,
  "/": 13,
  "0": 14,
  "1": 15,
  "2": 16,
  "3": 17,
  "4": 18,
  "5": 19,
  "6": 20,
  "7": 21,
  "8": 22,
  "9": 23,
  ":": 24,
  "?": 25,
  "A": 26,
  "B": 27,
  "C": 28,
  "D": 29,
  "E": 30,
  "F": 31,
  "G": 32,
  "H": 33,
  "I": 34,
  "J": 35,
  "K": 36,
  "L": 37,
  "M": 38,
  "N": 39,
  "O": 40,
  "P": 41,
  "R": 42,
  "S": 43,
  "T": 44,
  "U": 45,
  "V": 46,
  "W": 47,
  "X": 48,
  "Y": 49,
  "Z": 50,
  "a": 51,
  "b": 52,
  "c": 53,
  "d": 54,
  "e": 55,
  "f": 56,
  "g": 57,
  "h": 58,
  "i": 59,
  "j": 60,
  "k": 61,
  "l": 62,
  "m": 63,
  "n": 64,
  "o": 65,
  "p": 66,
  "q": 67,
  "r": 68,
  "s": 69,
  "t": 70,
  "u": 71,
  "v": 72,
  "w": 73,
  "x": 74,
  "y": 75,
  "z": 76,
  "è": 77,
  "é": 78,
  "ć": 79,
  "š": 80,
  "–": 81
}